00000000000
00110000100
10001100000
00001110100
00010000000
00001000001
00000011100